1111111111111111111111111111
1EPCCCCCCCCCC11CCCCCCCCCCPE1
1C1111C11111C11C11111C1111C1
1C1111C11111C11C11111C1111C1
1C1111C11111C11C11111C1111C1
1CCCCCCCCCCCCCCCCCCCCCCCCCC1
1C1111C11C11111111C11C1111C1
1CCCCCC11CCCC11CCCC11CCCCCC1
111111C11111011011111C111111
111111C11000000000011C111111
111111C11011100111011C111111
1PCCCCC11010000001011CCCCCP1
111111C00010000001000C111111
111111C11011111111011C111111
111111C11000000000011C111111
111111C11011111111011C111111
1CCCCCCCCCCCC11CCCCCCCCCCCC1
1C1111C11111C11C11111C1111C1
1CCC11CCCCCCC00CCCCCCC11CCC1
111C11C11C11111111C11C11C111
1CCCCCC11CCCC11CCCC11CCCCCC1
1C1111111111C11C1111111111C1
1EPCCCCCCCCCCCCCCCCCCCCCCPE1
1111111111111111111111111111
