1111111111111111111111111111111111111111111111111111111111
1CCCCCCCCCCCCCCCCCCCCCCCCCCCCCCCCCCCCCCCCCCCCCCCCCCCCCCCC1
1C111C111111111C111111111111111C11111111C111C11111C11111C1
1C111C111111111C111111111111111C11111111C111C11111C11111C1
1CCCCC111111111CCCCCCCCCCCCCCCCCCCCCCCCCC111CCCCCCCCCCCCC1
11111C111CCCCCCC1111111C11111110000000000111C1111111C11111
11111C111C11111C1111111C11111110111001110111C1111111C11111
11111C111C11111C1100011C11000110100000010111C1100011C11111
1CCCCC111CCE111C1100011C1100011010GGGG010111C1111111CCCCC1
11111C111111111C1100011C11000110111111110111C111CCCCC11111
11111C111111111C1111111C11111110000000000111C1111111C11111
11111C111111111C1111111C11111110111111110111C1111111C11111
1CCCCCCCCCCCCCCCCCCCCCCCCCCCCCCC11111111CCCCCCCCCCCCCCCCC1
1C1111C1111111111C11C1111111111CCCC11CCCC111111111C11111C1
1C1111C1111111111C11C1111111111C11C11C11C111111111C11111C1
1CCCCCCCCCCCCCCCCC11CCCCCCCCCCCC11CCPC11CCCCCCCCCCCCCCCCC1
1111111111111111111111111111111111111111111111111111111111
