11111111111111
1EP000000000C1
10100000010101
10100000010101
1P0000000000C1
11111111111111
