11111111111111
1EP00000P000C1
1010000001G101
10100000010101
1C0000000000C1
11111111111111
