11111111111111
1E000000000001
10100000010101
10100000010101
1P0C00000000C1
11111111111111
