11111111111111111
1E000000000000001
10100101000010101
10100100000010101
1P0000000000000C1
11111111111111111
