11111111111111
1G000000000001
11111100000001
1G001000001111
111110000000G1
1G010000000001
11110000000001
1EC000000000P1
11111111111111
10101011111111
11111111111111
