11111111111111
1G000000000001
10000000000001
10000000000001
10000000000001
10000000000001
10000000000001
1E00000C0000P1
11111111111111
10111111111111
11111111111111
