11111111111111
1G0000000000E1
11111111000001
10000000000001
1G000000000001
10000G00000001
10000000000001
1E000000CC00P1
11111111111111
10101011111111
11111111111111
