11111111111
1E00000P111
1G00G0CC111
11111111111
10101010101
11111111111
