111111111
1CP00E0G1
101C1G111
1G000G111
111111111
