111111111
1CP00E1G1
101111111
1G000G111
111111111
