11111111111111111111
10000000000000000001
10000000000000000001
10000000000000000001
10000000000000000CC1
111111000000P0000CC1
10000000000000000CC1
10000000000000000001
10000000000000000001
1000000000000G000001
10000000000000000001
10000000000000000001
1E000000000000000001
11111111111111111111
10101010111111111111
11111111111111111111
