11111111111111111111
1P000000G00000000001
10111001110011C11101
100000G0000000000001
10000000000100000001
10000000000100000001
1011111100C111G11101
100000G0000000000001
10000000000010000001
1000000000001E000001
11111111111111111111
10101010111111111111
11111111111111111111
