1111111111111111111111111111
1000C100000000000000001C0001
1011110111111111111110111101
1000000000000000000000000001
1011110110111111110110111101
1011110110111111110110111101
1000000110000110000110000001
1111110111110110111110111111
1111110111110110111110111111
1111110100000000000010111111
1111110101111111111010111111
1111110000GGEPPEGG0000111111
1111110101111001111010111111
1111110100000000000010111111
1111110101111111111010111111
1000000000000110000000000001
1011110111110110111110111101
1011110111110110111110111101
1000110000000000000000110001
1010110110111111110110110101
1010110110111111110110110101
1000000110000C00000110000001
1111111111111111111111111111
1010101011111111111111111111
1111111111111111111111111111
