111111111111111111111111111111
1PCCCCCCCCCCCC00000000000000E1
101111111111110000000011100001
100000000000000000110000000001
100000000000000000110000000001
100000000001000000000100000001
1011111100011101100001001G0001
100000000000000000000111110001
101111110000100000000100000001
101CCCC10000100000000000000001
10100G010000100111111110000001
101000010000100000000000000001
1010000100001001111111100G0001
10000000000010000G000000000001
100000110000100110000110000001
100000110000100000000000000001
10000000000G100000000000000001
1111111111111111111111111110G1
101010101010111111111111111111
111111111111111111111111111111
