11111111111111111111
1PCCCCCE1G000000G001
10111110111111010101
100000G0000000000001
10000000000G00000001
11111111111111111111
10101010111111111111
11111111111111111111
