111111111
1G00000E1
1CGC00001
10G000001
1C0G00001
100000001
100C00001
100000001
1P0C00001
111111111
101010101
111111111
