1111111111111111
1000P00100000001
1G111111101111G1
1ECGG00000010001
1111111111111111
