11111111111111111111
10CCC1CCCCCCCC1CCCC1
1C11C1C11CC11C1C11C1
1C1CCCCC1CC1CCCCC1C1
1C1C11C110011C11C1C1
1CCCCCC00G0G1C1CCCC1
1C1CCCC111111C1CC1C1
1C1CCCC100CC1C1CC1C1
1C1CCCC101111C1CC1C1
1C1CCCCCCCCCCC1CC1C1
1C1EC1C111111C1C11C1
1CCCC1CCCPCCCC1CCCC1
11111111111111111111
